##############################
##..........................##
#...........###............###
#.........#####...........####
###.###......................#
##...##..........##..........#
#.....#..........##........###
#.........###....##......#####
#.....#...###....##........###
##...##...###....##........###
#######..........####......###
#.....##.........######......#
#..##.###.......###........###
#####.####.....####........###
#####.#####.....###......#####
#.....###...........##.....###
#.....#...........###.#...####
#............................#
##############################